AQU = "countries/Aquitaine.txt"
ARG = "countries/Argentina.txt"
AST = "countries/Australie.txt"
AZR = "countries/Emirate of Azerbaijan.txt"
BAD = "countries/Baden.txt"
BAL = "countries/The Balkan League.txt"
BBA = "countries/British Baluschistan.txt"
BBE = "countries/British Bengal.txt"
BRA = "countries/Brazil.txt"
CAM = "countries/Cambodia.txt"
CAN = "countries/Canada.txt"
CHI = "countries/Empire of China.txt"
CSA = "countries/Confederate States.txt"
DEL = "countries/Delhi People's Republic.txt"
DEN = "countries/Kingdom of Denmark.txt"
DEZ = "countries/Kingdom of Dezarussiya.txt"
ENG = "countries/United Kingdom.txt"
FRA = "countries/Kingdom of France.txt"
GEO = "countries/Kingdom of Georgia.txt"
GRA = "countries/Grand Colombia.txt"
HOL = "countries/Netherlands.txt"
HUN = "countries/Kingdom of Hungary.txt"
IBE = "countries/Iberian Empire.txt"
IND = "countries/India.txt"
IRQ = "countries/Iraq.txt"
ITA = "countries/Kingdom of Italy.txt"
JAP = "countries/Japan.txt"
KAM = "countries/Kingdom of Kamarupa.txt"
KOR = "countries/Kingdom of Korea.txt"
LAN = "countries/Lan Na.txt"
MAG = "countries/Maghreb Union.txt"
MEX = "countries/Mexico.txt"
MON = "countries/Mongyang"
MOR = "countries/Great Moravia.txt"
NGF = "countries/North German Federation.txt"
NIN = "countries/Ning.txt"
NUS = "countries/Nusantara Empire.txt"
NZL = "countries/New Zealand.txt"
OIR = "countries/Oirat.txt"
PER = "countries/Persia.txt"
POM = "countries/Poland-Moravia.txt"
PRU = "countries/Peru.txt"
RUS = "countries/Russian Empire.txt"
SAF = "countries/Saffarid Empire.txt"
SGF = "countries/South German Federation.txt"
SWF = "countries/Sweden-Finland.txt"
SYR = "countries/Syrian Nationalist State.txt"
TUL = "countries/Tulunid Empire.txt"
UMA = "countries/Umayyad Emirate.txt"
UNI = "countries/United Indies.txt"
USA = "countries/United States.txt"
USC = "countries/United States of Central America.txt"
USI = "countries/USIR.txt"
VIZ = "countries/Vizantiyan Empire.txt"
YAR = "countries/Yarkand SR.txt"
